...............................
...............................
...............................
...............................
...............................
...............................
............]]]]]]]]...........
............]]]]]]]]...........
............]]]^^]]]...........
..........############.........
..........############.........
...............##..............
.......!!!.....##.....%%%......
.......!!!.....##.....%%%......
.......!^!.....##.....%^%......
.....#####################.....
.....#####################.....
...............##..............
...............##..............
...............##..............
...............##..............
...............##..............
...............##..............
...............##..............
...............##..............
.........########..............
.........########..............
.........##....................
.........##....................
.........##....................
.........##....................