.........##....................
.........##....................
.........######################
.........######################
.........##....................
.........##....................
...%%%...##....................
...%%%...##....................
...%^%...##....................
...########....................
...########....................
.........##....................
.........##....................
.........##....................
...!!!...##....................
...!!!...##....................
...!^!...##....................
...################............
...################............
.................##..]]]]]]]...
.................##..]]]]]]]...
.................##..]]]^]]]...
.................###########...
.................###########...
...................##..........
...##################..........
...##################..........
...##..........................
...##..........................
...##..........................
...##..........................