.............##................
.............##................
.............##................
.............##................
.............##................
.............##................
.............##................
.............##................
.............##................
.............##....*...........
.............##................
.............##..........*.....
......*......##................
.............##........*.......
.............##....*...........
.............##................
.......*.....##...........*....
.............##.......*........
....*........##................
.............##................
.......*.....##....*...........
.............##................
...*.........##........*.......
.............##...........*....
.............##................
.............##....*...........
.......*.....##................
.............##................
.............##.......*........
.............##................
.............##................