...##..........................
...##..........................
...######......................
...######......................
.......##......................
.......##......................
.......##.]]]]]]]..............
.......##.]]]]]]]..............
.......##.]]]^]]]..............
.......#############...........
.......#############...........
.............##................
.............##................
.............##................
.............##################
.............##################
.............##................
.............##................
.............##................
.............##....!!!.%%%.....
.............##....!!!.%%%.....
.............@#....!^!.%^%.....
.............###############...
.............###############...
.............##................
.............##................
.............##................
.............##................
.............##................
.............##................
.............##................