#####################
#####################
##$$$$$$$$$$$$$$$$$##
##$$$$$$$$$$$$$$$$$##
##$$$$$$$$$$$$$$$$$##
##$$$$$$$$$$$$$$$$$##
##$$$$$$$$$$$$$$$$$##
##$$$$$$$$$$$$$$$$$##
##$$$$$$$$$$$$$$$$$##
==$$$$$$$$$$$$$$$$$##
==$$$$$$$$$$$$$$$$$##
==$$$$$$$$$$$$$$$$$##
##$$$$$$$$$$$$$$$$$##
##$$$$$$$$$$$$$$$$$##
##$$$$$$$$$$$$$$$$$##
##$$$$$$$$$$$$$$$$$##
##$$$$$$$$$$$$$$$$$##
##$$$$$$$$$$$$$$$$$##
##$$$$$$$$$$$$$$$$$##
#####################
#####################