*********************
*********************
**#################**
**#################**
**########@########**
**#################**
#####################
#####################
#####################
#####################
#####################
#####################
#####################
#####################
#####################
#####################
#####################
#####################
#####################
#####################
##########=##########