********#############
*###@################
*####################
*####################
*####################
#####################
#####################
#####################
#######**############
#######**############
#######**########*###
#######**########*###
#######**########*###
#######**########*###
#######**############
#######**############
#####################
#####################
#####################
#####################
##########=##########