********#############
*####################
*####################
*####################
*####################
#####################
#####################
#####################
####**###############
####**###############
####**###########*###
####**###########*###
####**###########*###
####**###########*###
####**###############
####**###############
#####################
#####################
#####################
#####################
#####################