.............##................
.............##................
.............##................
.............##................
.............##................
.............##................
.............##................
.............##................
.............##................
.............##................
.............##................
.....***.....##................
.....***.....##................
.....***.....##................
....###########................
....###########................
.............##................
.............##................
.............##................
.............##................
.............##................
.............##................
.............##.*******........
.............##.*******........
.............##.*******........
.............##.*******........
.............############......
.............############......
...............................
...............................
...............................