.............##................
.............##................
.............##................
.............##................
.............##................
.............##................
.............##................
.............##................
.............##................
.............##................
.............##................
.....***.....##................
.....***.....##................
.....***.....##................
..#############................
..#############................
.............##................
.............##................
.............##................
.............##................
.............##................
.............##................
.............##................
.............##*******.........
.............##*******.........
.............##*******.........
.............############......
.............############......
...............................
...............................
...............................